bdisanto	bdisanto	M
hcousin	hcousin	M
demoM	demoM	M
hugoboss	pqss	C
lopez	pass	C
bendis	pass	C
ertore	xMkgh9	C
dinaya	DDJzxv	C
dowrig	JFeNXp	C
stlean	WKpNmz	C
muwolf	tKKFgW	C
ghharr	Vyg7QA	C
drcala	sNbf3z	C
sikemp	aXCJm4	C
lishar	QXvzWc	C
emfint	65F7nh	C
arstee	VQt64W	C
capyon	xwdTYp	C
maastr	uBvVbq	C
leirmt	3ZmQdP	C
dechri	NVVXEA	C
